東方動画BGM支援ショボいアレンジ集（sm23930994）
データ取扱説明書


本楽曲集のmidiデータの取り扱いについて

友人に個人的にあげる		→ OK
┗ この取扱説明書も一緒にあげると吉。

不特定多数に再配布する		→ だめ

MIDI打ち込みの参考にする	→ OK
┗ 「反面教師にする」も可。

コピペ or 改変して再利用する	→ だめ

アレンジをパクる		→ だめ

"音源変えて鳴らしてみた"を投稿	→ OK
┗ オリジナル要素を付加した作品（"ショボくないアレンジにしてみた"など）も歓迎。


・06_kohroh（midi）	「紅楼　〜 Eastern Dream...」のショボいアレンジです。
・06_lunate（midi）	「ルーネイトエルフ」のショボいアレンジです。
・06_tepes（midi）	「ツェペシュの幼き末裔」のショボいアレンジです。
・07_bucuresti（midi）	「ブクレシュティの人形師」のショボいアレンジです。
・07_miyako（midi）	「天空の花の都」のショボいアレンジです。
・07_moteasobi（midi）	「人形裁判　〜 人の形弄びし少女」のショボいアレンジです。
・07-5_feast（midi）	「Demystify Feast」のショボいアレンジです。
・07-5_saigetsu（midi）	「砕月」のショボいアレンジです。
・08_eiya（midi）	「永夜の報い　〜 Imperishable Night.」のショボいアレンジです。
・08_fushi（midi）	「月まで届け、不死の煙」のショボいアレンジです。
・08_kyohki（midi）	「狂気の瞳　〜 Invisible Full Moon」のショボいアレンジです。
・09_60（midi）		「六十年目の東方裁判　〜 Fate of Sixty Years」のショボいアレンジです。
・09_flowering（midi）	「フラワリングナイト」のショボいアレンジです。
・09_oriental（midi）	「オリエンタルダークフライト」のショボいアレンジです。
・10_genfuhkei（midi）	「少女が見た日本の原風景」のショボいアレンジです。
・10_kappa（midi）	「芥川龍之介の河童　〜 Candid Friend」のショボいアレンジです。
・10_ummei（midi）	「運命のダークサイド」のショボいアレンジです。
・10-5_kohron（midi）	「甲論乙駁」のショボいアレンジです。
・10-5_uchoh（midi）	「有頂天変　〜 Wonderful Heaven」のショボいアレンジです。
・11_kaidoh（midi）	「旧地獄街道を行く」のショボいアレンジです。
・11_mantle（midi）	「業火マントル」のショボいアレンジです。
・11_shitai（midi）	「死体旅行　〜 Be of good cheer!」のショボいアレンジです。
・12_kenshoh（midi）	「小さな小さな賢将」のショボいアレンジです。
・12_kyakusen（midi）	「幽霊客船の時空を越えた旅」のショボいアレンジです。
・12_UFO（midi）	「夜空のユーフォーロマンス」のショボいアレンジです。
・12-3_X（midi）	「アンノウンX　〜 Unfound Adventure」のショボいアレンジです。
・12-3_yuhkyuh（midi）	「悠久の蒸気機関」のショボいアレンジです。
・12-8_dance（midi）	「真夜中のフェアリーダンス」のショボいアレンジです。
・12-8_magus（midi）	「メイガスナイト」のショボいアレンジです。
・13_furuki（midi）	「古きユアンシェン」のショボいアレンジです。
・13_monzen（midi）	「門前の妖怪小娘」のショボいアレンジです。
・13_sado（midi）	「佐渡の二ッ岩」のショボいアレンジです。
・13-5_aru（midi）	「人気のある場所」のショボいアレンジです。
・13-5_nai（midi）	「人気のない場所」のショボいアレンジです。
・14_kobito（midi）	「輝く針の小人族　〜 Little Princess」のショボいアレンジです。
・14_mermaid（midi）	「秘境のマーメイド」のショボいアレンジです。
・14_reverse（midi）	「リバースイデオロギー」のショボいアレンジです。
・14_storm（midi）	「マジカルストーム」のショボいアレンジです。
・14_werewolf（midi）	「孤独なウェアウルフ」のショボいアレンジです。
・14-3_midnight（midi）	「ミッドナイトスペルカード」のショボいアレンジです。
・14-3_romantic（midi）	「ロマンチック逃飛行」のショボいアレンジです。
・97_hifuh（midi）	「少女秘封倶楽部」のショボいアレンジです。
・97_michi（midi）	「未知の花　魅知の旅」のショボいアレンジです。
・97_troja（midi）	「トロヤ群の密林」のショボいアレンジです。
・98_maestra（midi）	「アリスマエステラ」のショボいアレンジです。
・98_shinwa（midi）	「神話幻想　〜 Infinite Being」のショボいアレンジです。
・98_shohshitsu（midi）	「夢消失　〜 Lost Dream」のショボいアレンジです。
・98_strawberry（midi）	「Strawberry Crisis!!」のショボいアレンジです。
・99_eastern（midi）	「テーマ・オブ・イースタンストーリー」のショボいアレンジです。
・99_kagaku（midi）	「幻想科学　〜 Doll's Phantom」のショボいアレンジです。
・99_potion（midi）	「Witch of Love Potion」のショボいアレンジです。
・99_soratobu（midi）	「空飛ぶ巫女の不思議な毎日」のショボいアレンジです。
・99_yorudakara（midi）	「夜だから眠れない」のショボいアレンジです。



2014/07/05
森の子リスのミーコの大冒険
user/11781062